T1_SIENAX_headsize_scaling                                bb_IDP_T1_SIENAX             1	" IDP_T1_SIENAX_headsize_scaling ratio float Volumetric scaling from the T1 head image to standard space "
T1_SIENAX_peripheral_GM_norm_vol                          bb_IDP_T1_SIENAX             2	" IDP_T1_SIENAX_peripheral_grey_normalised_volume mm3 float Volume of peripheral cortical grey matter (from T1 brain image, normalised for head size) "
T1_SIENAX_peripheral_GM_unnorm_vol                        bb_IDP_T1_SIENAX             3	" IDP_T1_SIENAX_peripheral_grey_unnormalised_volume mm3 float Volume of peripheral cortical grey matter (from T1 brain image) "
T1_SIENAX_CSF_norm_vol                                    bb_IDP_T1_SIENAX             4	" IDP_T1_SIENAX_CSF_normalised_volume mm3 float Volume of ventricular cerebrospinal fluid (from T1 brain image, normalised for head size) "
T1_SIENAX_CSF_unnorm_vol                                  bb_IDP_T1_SIENAX             5	" IDP_T1_SIENAX_CSF_unnormalised_volume mm3 float Volume of ventricular cerebrospinal fluid (from T1 brain image) "
T1_SIENAX_GM_norm_vol                                     bb_IDP_T1_SIENAX             6	" IDP_T1_SIENAX_grey_normalised_volume mm3 float Volume of grey matter (from T1 brain image, normalised for head size) "
T1_SIENAX_GM_unnorm_vol                                   bb_IDP_T1_SIENAX             7	" IDP_T1_SIENAX_grey_unnormalised_volume mm3 float Volume of grey matter (from T1 brain image) "
T1_SIENAX_WM_norm_vol                                     bb_IDP_T1_SIENAX             8	" IDP_T1_SIENAX_white_normalised_volume mm3 float Volume of white matter (from T1 brain image, normalised for head size) "
T1_SIENAX_WM_unnorm_vol                                   bb_IDP_T1_SIENAX             9	" IDP_T1_SIENAX_white_unnormalised_volume mm3 float Volume of white matter (from T1 brain image) "
T1_SIENAX_brain-norm_vol                                  bb_IDP_T1_SIENAX             10	" IDP_T1_SIENAX_brain-normalised_volume mm3 float Volume of brain (grey+white, from T1 brain image, normalised for head size) "
T1_SIENAX_brain-unnorm_vol                                bb_IDP_T1_SIENAX             11	" IDP_T1_SIENAX_brain-unnormalised_volume mm3 float Volume of brain (grey+white, from T1 brain image) "
T1_FIRST_left_thalamus                                    bb_IDP_T1_FIRST_vols         1	" IDP_T1_FIRST_left_thalamus_volume mm3 float Volume of left thalamus (from T1 brain image) "
T1_FIRST_right_thalamus                                   bb_IDP_T1_FIRST_vols         2	" IDP_T1_FIRST_right_thalamus_volume mm3 float Volume of right thalamus (from T1 brain image) "
T1_FIRST_left_caudate                                     bb_IDP_T1_FIRST_vols         3	" IDP_T1_FIRST_left_caudate_volume mm3 float Volume of left caudate (from T1 brain image) "
T1_FIRST_right_caudate                                    bb_IDP_T1_FIRST_vols         4	" IDP_T1_FIRST_right_caudate_volume mm3 float Volume of right caudate (from T1 brain image) "
T1_FIRST_left_putamen                                     bb_IDP_T1_FIRST_vols         5	" IDP_T1_FIRST_left_putamen_volume mm3 float Volume of left putamen (from T1 brain image) "
T1_FIRST_right_putamen                                    bb_IDP_T1_FIRST_vols         6	" IDP_T1_FIRST_right_putamen_volume mm3 float Volume of right putamen (from T1 brain image) "
T1_FIRST_left_pallidum                                    bb_IDP_T1_FIRST_vols         7	" IDP_T1_FIRST_left_pallidum_volume mm3 float Volume of left pallidum (from T1 brain image) "
T1_FIRST_right_pallidum                                   bb_IDP_T1_FIRST_vols         8	" IDP_T1_FIRST_right_pallidum_volume mm3 float Volume of right pallidum (from T1 brain image) "
T1_FIRST_left_hippocampus                                 bb_IDP_T1_FIRST_vols         9	" IDP_T1_FIRST_left_hippocampus_volume mm3 float Volume of left hippocampus (from T1 brain image) "
T1_FIRST_right_hippocampus                                bb_IDP_T1_FIRST_vols         10	" IDP_T1_FIRST_right_hippocampus_volume mm3 float Volume of right hippocampus (from T1 brain image) "
T1_FIRST_left_amygdala                                    bb_IDP_T1_FIRST_vols         11	" IDP_T1_FIRST_left_amygdala_volume mm3 float Volume of left amygdala (from T1 brain image) "
T1_FIRST_right_amygdala                                   bb_IDP_T1_FIRST_vols         12	" IDP_T1_FIRST_right_amygdala_volume mm3 float Volume of right amygdala (from T1 brain image) "
T1_FIRST_left_accumbens                                   bb_IDP_T1_FIRST_vols         13	" IDP_T1_FIRST_left_accumbens_volume mm3 float Volume of left accumbens (from T1 brain image) "
T1_FIRST_right_accumbens                                  bb_IDP_T1_FIRST_vols         14	" IDP_T1_FIRST_right_accumbens_volume mm3 float Volume of right accumbens (from T1 brain image) "
T1_FIRST_brain_stem+4th_ventricle                         bb_IDP_T1_FIRST_vols         15	" IDP_T1_FIRST_brain_stem+4th_ventricle_volume mm3 float Volume of brain stem + 4th ventricle (from T1 brain image) "

